#################
#.#.#.....#....E#
#.#.#######.#.#.#
#.#.........#...#
#.#########.#####
#.#.............#
#.#####.#######.#
#S..............#
#################
